 6  6  6  6  6  6  0  0  0  0  0  0 41  0  0  0  0  0  0  0  0  0  0  0  0
 6  6  6  0  8 42 42 42 42 42 42 42  9  6  6  0  0  0  0  0  0  0  0  0  0
 6  7  0  0 41  0  0  0  0  0  0  0  6  6  6 35 36  0 35 36  0 35 36  0  0
 6  6  0  0 41  0  0  0  0  0  0  0 40  0  6 37 38  0 37 38  0 37 38  0  0
42 42 42 42  9  0  0 35 36  0  7  0  0  0  6  6  6  6  6  6  6  6  6  6  6
 0  0  0  0  0  0  0 37 38  0  0  0  0  0 35 36  6  0  0  0  0  0  0  0  0
 0  0 35 36  0  0  7  0  0  0  0  0  0  0 37 38  0  0  0  0  0  0  0  0  0
 0  0 37 38  0  0  0  0  0  0  0  0  0  0  0  6  0  0  6  6  6  6  6  6  6
 0  0  0  0  0  0  0  0  0  0  0  0  0  0 35 36  0  0  6  0  0 35 36  0  0
 0  0  0  0  0  0  0  0  0  0  6  0  0  0 37 38  0  0  6  0  0 37 38  0  0
 0 35 36  0 35 36  0 35 36  0  6  6  0  0  0  6  0  0  6 35 36  0  0  0  0
 0 37 38  0 37 38  0 37 38  0  0  6  6  0 35 36  0  0  6 37 38  0  0 40  0
 6  6  6  6  6  6  6  6  0 35 36  6  6  6 37 38  0  0  6  0  0  0  0  0  0
 0  0  0  0  0  0  0  0  6 37 38  6  6  6  0  6  0  0  6 35 36  0  0  0  0
 0  0  0  0  0  0  0  0  0  6  6  6  6  6  6  6  0  0  6 37 38  0  0  0  0
 6  6  6  6  6  6  6  0  0  0  0  0  0  0  0  0  0  0  6  0  0  0  0  0  0
 0 35 36  0 35 36  0  6  0  0  0  0  0  0  0  0  0  6 35 36  0  0  0  0  0
 0 37 38  0 37 38  0  0  6  6  6  6  6  6  6  6  6  0 37 38  0  0  0  0  0
 0  0  0  7  0  0  0 35 36  0 35 36  0 35 36  0 35 36  0  0  0 39  0  0  0
 0  0  0  0  0  0  0 37 38  0 37 38  0 37 38  0 37 38  0  0  0  0  0  0  0