 0  0  0  0  0  0  0  0  0  0  0 41  0  0  0  0  0  0  0  0  0  0  0  0  0
 0  0  6  6  6 35 36  0  0  0  0 41  0  0 35 36  0  0  0  0  0  0  0  0  0
 0  0  6  6  6 37 38  0  8 42 42  9  0  0 37 38  0  0  0  7  0  0  0  0  0
 0 35 36  0  0  0  0  0 41  0  0  0  0 39  0  0  0  0  0  0  6  0  0  0  0
 0 37 38  0  0  7  0  0 41  7  0  0  6  0  0  0  0  0  0  0  6  0  0  0  0
 0  0  0  0  0  0  0  0 41  0  0  0  0  6  6  0  0  0  0  0  0  0 40  0  0
42 42 42 42 42 42 42 42  9  0 35 36  0  0  0  0 35 36 35 36  0  0  0  0  0
 0  0  0  0  0  6  0  0  0  0 37 38  0  0  0  0 37 38 37 38 35 36  0  0  0
 0  0  0  0  0  0  0  0  0  0  0  0  0  0  0 35 36  0  0  0 37 38 35 36  0
 0  0  0  0  0  0  0  0  0  0  0  0  0  0  0 37 38  0  0  0  0  0 37 38  0
 0  0  0  0  0  0 35 36  0  0  0  0  0  0 35 36  0  0  0  0  0  0  0 35 36
 0  0  0  0  0  0 37 38  0  0  0  0  0  0 37 38  0  0  0  7  0  0  0 37 38
 0 35 36  0  0  0  0  0  0  0  0  0  0  0  0  0  0  0  0  0  0  0  0 35 36
 0 37 38  0  0  0  0  0  0  0  0  0  0  0  0  0  0  0  0  0  0  0  0 37 38
 0  0  0  0  0 35 36  0  0  0  0  0  0  0 35 36  0  0  0  0  0  0  0 35 36
 0  0  0  7  0 37 38  0  0  0  0  0  0  0 37 38  0  0  0  0  7  0  0 37 38
 0  0  0  0  0  0  0  0  0 35 36  0  0  0  0 35 36  0  0  0  0  0 35 36  0
 0  0  0  0  0  6  0  7  0 37 38  0  0  0  0 37 38  0  0  0 35 36 37 38  0
 0  0  0  0  0  0  0  0  0  0  0  0  0 40  0  0 35 36 35 36 37 38  0  0  0
 0  0  0  0  0  0  0  0  0  0  0  0  0  0  0  0 37 38 37 38  0  0  0  0  0