0  0  0  0  0  0  0  0 35 36 40  0 35 36 35 36 35 36  6  6 41  6  6  6  6
0  0  0  0  0  0  0  0 37 38  0  0 37 38 37 38 37 38  6  6 41  6  6  6  6
0 35 36  0  0  0  0  0  0 35 36 39  0 35 36  0  0  0  6  6 41  6  6  6  6
0 37 38  0  0  0  0  0  0 37 38  0  0 37 38  0 40  0  6  6 41  6  6  6  6
0  0  0  0  0  0  0 39  0  0 35 36 35 36  0  0  0  0  6  6 43 42 42 42 42
0  0 39  0  0  0  0  0  0  0 37 38 37 38  0 40  0 39  0  6  0  6  6  6  6
0  0  0  0  0  0  0  0  0  7  0  0  0  0  0  0  0  0  0  0  6  6  6  6  6
0 35 36  0  0  0  0 40  0  0  0 39  0 40  0 35 36  0 39  0  0  6  6  6  6
0 37 38  0  0  0  0  0  0 39  0  0  0  0  0 37 38  0  0  0  0  0  6  6  6
0  0  0  0  0  0  0  0  0  0  0  0 39  0  0  0  0  0  0  0  0  0  0  6  6
0 39  0  0  0  0  0  0  0  0  0  7  0  0 39  0  0  0 39  0  0  0  0  0  6
0  0  0  0  0  0  0  0  0  0  0  0  0  0  0  0  0  0  0  0  0 40  0  0  0
0  0 40  0  0  0  0  0  0  0  0  0  0  0  0  0  0  0  0  0  0  0  0  0  0
0  0  0  0  0  0  0  0  0  0  0  0  0  0  0 35 36  0  0  0  0  0  0  0  0
0 35 36  0  0  0  0  0  0  0  0  0  0  0  0 37 38  0  0  0  0  0  0  0  0
0 37 38  0  0  0  0  0  0  0  0  0  0  0  0  0  0  0  0  0  0  0  0  0  0
0  0  0  0  0  0  0  0  0  0  0  0  0  0  0  0  0  0  0  0  0  0  0  0  0
0  0  0  0 35 36  0  0  0  0  0  0  0  0  0  0  0  0  0  0  0 35 36  0  0
0  0  0  0 37 38  0 35 36  0  0  0  0 35 36  0  0 39  0  0  0 37 38  0  0
0  0  0  0  0  0  0 37 38  0  0  0  0 37 38  0  0  0  0  0  0  0  0  0  0