 0  0  0  0 17 13 13 13 13 13 13 13 13 13 13 13 13 13 13 13 13 13 13 13 21
 0  0  0  0 16 12 12 12 12 12 12 12 12 12 12 12 12 12 12 12 12 12 12 12 20
 0  0  0  0 18  0  0  0  0  0  0  0  0  0  0  0  0  0  0  0  0  0  0  0 19
 0  0  0  0 18  0  0  0  0  0  0  0  0  0  0  0  0  0  0  0  0  0  0  0 19
 0  0  0  0 18  0  0  0  0  0  0  0  0  0  0  0  0  0  0  0  0  0  0  0 19
 0  0  0  0 18  0  0  0  0  0  0  0  0  0  0  0  0  0  0  0  0  0  0  0 19
 0  0  0  0 18  0  0  0  0  0  0  0  0  0  0  0  0  0  0  0  0  0  0  0 19
 0  0  0  0 18  0  0  0  0  0  0  0  0  0  0  0  0  0  0  0  0  0  0  0 19
 0  0  0  0 18  0  0  0  0  0  0  0  0  0  0  0  0  0  0  0  0  0  0  0 19
 0  0  0  0 18  0  0  0  0  0  0  0  0  0  0  0  0  0  0  0  0  0  0  0 19
 0  0  0  0 18  0  0  0  0  0  0  0  0  0  0  0  0  0  0  0  0  0  0  0 19
 0  0  0  0 18  0  0  0  0  0  0  0  0  0  0  0  0  0  0  0  0  0  0  0 19
 0  0  0  0 18  0  0  0  0  0  0  0  0  0  0  0  0  0  0  0  0  0  0  0 19
 0  0  0  0 18  0  0  0  0  0  0  0  0  0  0 19 15 15 15 15 15 15 15 15 15
 0  0  0  0 18  0  0  0  0  0  0  0  0  0  0 19 14 14 14 14 14 14 14 14 14
 0  0  0  0 18  0  0  0  0  0  0  0  0  0  0 19  0  0  0  0  0  0  0  0  0
 0  0  0  0 18  0  0  0  0  0  0  0  0  0  0 19  0  0  0  0  0  0  0  0  0
 0  0  0  0 18  0  0  0  0  0  0  0  0  0  0 19  0  0  0  0  0  0  0  0  0
 0  0  0  0 15 15 15 15  0  0  0  0 15 15 15 15  0  0  0  0  0  0  0  0  0
 0  0  0  0 14 14 14 14 14 11 11 14 14 14 14 14  0  0  0  0  0  0  0  0  0