 0  0  0  0  0  0  0  0  0  0  0  0 41  0  0  0  0  0  0  0  0  0  0  0  0
 0  0  0 35 36  0  0  0  0  0  0  0 43 42 42 42 42 42 44  0  0  0  0  0  0 
 0  0  0 37 38  0  0  0  0  0  0  0  0  0  0  0  0  0 41  0  0  0 35 36  0 
 0  0  0  0  0  0  0  0  0  0  0  0  0  0 35 36  0  0 41  0  0  0 37 38  0 
 0  0  0  0  0  0  0  0  0  0  0  0  0  0 37 38  0  0 43 42 42 44  0  0  0 
 0  0  0  0  0  0  0  0  0  0  0  0  0  0  0  0  0  0  0  0  0 41  0  0  0 
 0  0  0  0  0  0 35 36  0  0  0  0  0  0  0  0  0  0  0  0  0 43 42 42 42 
 0  0  0  0  0  0 37 38  0  0  0  0  0  0  0  0  0  0  0  0  0  0  0  0  0 
 0 35 36  0  0  0  0  0  0  0  0  0  0  0  0  0  0  0  0  0  0  0  0  0  0 
 0 37 38  0  0 50 55  0  0 39  0  0  0  0  0  0  0  0  0  0  0  0  0  0  0 
 0  0  0 50 51 52 57 56 55  0  0  0  0  0  0  0  0  0  0  0  0  0  0  0  0 
 0  0 51 52 53 54 59 58 57 56  0  0  0  0  0  0 35 36  0  0  0  0  0  0  0 
 0  0 53 54 47 47 47 47 59 58  0  0  0  0  0  0 37 38  0  0  0  0  0  0  0 
35 36 48 47 62 47 47 62 47 49  0  0  0  0  0  0  0  0  0  0  0  0  0  0  0 
37 38 48 47 47 47 47 47 47 49  0 35 36  0  0  0  0  0  0  0  0  0  0  0  0 
46  0 48 63 47 47 47 47 63 49  0 37 38  0  0  0  0  0  0  0 30  0  0  0  0 
 0 46 48 47 47 60 61 47 47 49  0  0  0  0  0 40  0  0  0  0 31 45  0  0  0 
 0  0  0  0  0  0  0  0  0  0  0  0  0  0  0  0  0  0  0  0  0  0  0  0  0 
 0  0 35 36  0  0  0  0  0  0  0  0  0  0  0  0  0  0  0  0  0  0  0  0  0 
 0  0 37 38  0  0  0  0  0  0  0  0  0  0  0  0  0  0  0  0  0  0  0  0  0