0  0  0  0  0  0  0  0  0  0  0  0  0  0  0  0  0  0  0 41  0 35 36  0  0
0 35 36  0  0 35 36  0 39  0  0  0  0  6  0  6  0  0  0 41  0 37 38  0  0
0 37 38  0  0 37 38  0  0  0  6  0  0  0  0  0  0  0  0 41  0  0  0  0  0
0  0  0  0  0  0  0  0  0  0  0  0  0 40  0  0  0  0  0 41  0  0  7  0  0
0  0  0  0  0  0  0  0  0 35 36  0  0  0  0  0  0  0  0 41  0  0  0  6  0
0  0  0  0  0  0  0  0  0 37 38  0  0  0  0  7  0  0  0 41  0 35 36  0  0
0  0  0  0  0  0  0  0  0  0  0  0  0  6  0  0  0  0  0 41  0 37 38  0  0
0  0  0  0  0  0  0  0  0  0  6  0  0  0  0  0  0  0  0 41  6  0  0  0  0
0  0 35 36  0  0  0  0  0  0  0  0 35 36  0  0  0  6  0 41  6  6  0  0  0
0  0 37 38  0  0  0  0  0  0  0  0 37 38  0  0  0  0  0 41  0  0  0  0  0
0  6  0  0  0 40  0  0  0  0  0  0  0  0  0  0  0  0  0 41  0 35 36  0  0
0  0  0  0  0  0  0  0  0  0  0  0  0  0  0  0  0  0  0 41  0 37 38  0  0
0  0  0 35 36  0  0 35 36  0  0  0  0  0 35 36  0  0  0 41  0  0  0  0  0
0  6  0 37 38  0  0 37 38  0  0  0  0  0 37 38  0  0  0 41  0  0  0  6  0
0  0  0  0  0  0  0  0  0  0  0  0  0  0  0  0  0  7  0 43 42 42 42 44  0
0  0  0  6  0 39  0  0  0  0  0  0  0  0  0  0  0  0  0  0  0  0  0 41  0
0  0  0  0  0  0  0  0 35 36  0  0  0  0  0 35 36  6  0  0  0  6  0 41  0
0  0 35 36  0  0  0  0 37 38  0  0  0  0  0 37 38  0  0 35 36  0  0 41  0
0  0 37 38  0  0  0  0  0  0  0  0  0  0  0  0  0  0  0 37 38  0  0 41  0
0  0  0  0  0  0  0  0  0  0  0  0  0  0  0  0  0  0  0  0  0  0  0 41  0