0  0  0  0  0  0  0  0  0  0  0  0  0 35 36  0  0  0 35 36  0  0  0  0  0
0  0 35 36  0  0  0  0  0  0  0  0  0 37 38  7 35 36 37 38  0  0 35 36 39
0  0 37 38  0  0  0 35 36  0  0  0 35 36  6  6 37 38  0  0 35 36 37 38  0
0  0  0  0  0  0  0 37 38  0  0  0 37 38 35 36  0  0 35 36 37 38  0  0  0
0  0  0  6  0  0  0  0  0  0  0  0  7  6 37 38 35 36 37 38  0  0  0  0  0
0  0  0 35 36  0 35 36  0  0  0 35 36  6 35 36 37 38  0  0  0  0  0  0  0
0  0  0 37 38  0 37 38  0  0  0 37 38  6 37 38  0  0  0  0  0  0  0  0  0
0  0  6  0  0  0  0  0  0  0  0  6  6  0 35 36  0  0  0  0  0  0  0  0  0
0  6  0  0  0 35 36  0  0  0  0  0 40  0 37 38  0  0  0  0  0  0  0  0  0
0  0 35 36  0 37 38  0  0  0  0 35 36  0 35 36  0  0  0  0 35 36  0  6  0
0  0 37 38  0  0  0  0  0  0  0 37 38  0 37 38  0  0  0  0 37 38  0  6  0
0  6  0  0  0  0 40  0  0  0  0  0 35 36 35 36  0  0  0  0  0  0  0  0  0
0  0  0 39  0  0  0  0  0  0  0  0 37 38 37 38  0  0  0  0  0  0  0  7  0
0  0  0 35 36  0  0  0  0  0  0  0  0  0  0  0  0  0  0 35 36  0  0  0  0
0  0  0 37 38  0  0 35 36  0  0  0  0  0  0  0  0  0  0 37 38  0  6  0  0
0 35 36  0  0  0  0 37 38  0  0  0  0  0  0  0  0  0  0  0  0  0  6  0  0
0 37 38  0  0  0  0  0  0  0  0  0  0  0  0 35 36  0  0 40  0  0  0  0  0
0  0  0  0  6 35 36  0  0  0  0 35 36  0  0 37 38  0  6  0 35 36  0  0  0
0  0  0  6  6 37 38  0  0  0  0 37 38  0  0  0  6  0  0  0 37 38  0  0  0
0  0  0  0  0  0  0  0  0  0  0  0  0  0  0  6  0  0  0  0  0  0  0  0  0