 0  0  0  0  0 50 55  0  0  0 35 36  0  0  0  0 41  0  0  0 35 36  0  0  0
39  0  0 50 51 52 57 56 55  0 37 38  0  0  0  0 41  7  0  0 37 38  0  0  0
 0  0 51 52 53 54 59 58 57 56  0  0  0  8 42 42  9  0  0  0  0  0  0  0  0
 0  0 53 54 47 47 47 47 59 58  0 35 36 41  0  0  0  0  0  0  0  0  0  0  0
 0 46 48 47 62 47 47 62 47 49  0 37 38 41  0  0  0  0  0  0  0 35 36  0  0
46  0 48 47 47 47 47 47 47 49  0  0  0 41  0  0  0  0  0  0  0 37 38  0  0
 0 46 48 63 47 47 47 47 63 49  0  0  0 41  0  0  0  0  0  0  0  0  0  0  0
 0  0 48 47 47 60 60 47 47 49  0  0  0 41  0  0  0  0 35 36  0  0  0  7  0
 0  0  0  0  0  0  0  0  0  0 35 36  0 41  0  0  0  0 37 38  0  0  0  0  6
 0  0  0  0  0  0  0  0  0  0 37 38  0 41  0  0  0  0  0  0  0 35 36  0  0
35 36  6  6  0  0  0 30  0  0  0  0  0 41  0  0  0  0  0  0  0 37 38  6  0
37 38  0  6  0  0 45 31  0  0  0  0  0  0  0  0  0  0  6  0  0  0  6  0  0
 0  0  0  0  0  0  0  0  0  0  0  7  0  0  0  0  0  0  0 35 36  0  0  0  0
 0  0  0  0  0  0  0  0  0  0  0  0  0  0  0  0  0  0  0 37 38  0 40  0  0
 0  0  0  0  0  0  0  0  0  0  0  0  0  0  0  0  0  0  6  0  0  0  6  0  0
 0  0  0  0  0  0  0  0  0  0  0  0  0  0  0  0 35 36  0  0  0  0  0  0  0
 0  0  0 35 36  0  0  0 35 36  0  0  0 41  0  0 37 38  0  0  0 35 36  0  0
 0  0  0 37 38  0  0  0 37 38  0  0  0 41  0  0  0  0  0  0  0 37 38  0  0
42 42 42 42 42 42 42 42 42 42 42 42 42  9  0  0  0  0 39  0  0  0  0  0  0
 0  0  0  0  0  0  0  0  0  0  0  0  0  0  0  0  0  0  0  0  0  0  0  0  0