0  0  0 35 36  0  0  0  0 35 36  0  0  0  0  0 41  0  0  0  0  0  0  0  0
0  0  0 37 38  6  0  0  0 37 38  0  6  6  0  0 41  0  0 35 36  0  0  0  0
0  0  0  0  0  0  0  0  0  0  0  0  0  0  0  0 41  0  0 37 38  0 35 36  0
0  0  0  0  0  0  0  0  0  0  0  0  0  0  0  0 43 42 44  0  6  0 37 38  0
0 40  0  0  0  0  0  0  0  0  0  0  0  0  0  0  0  0 41  6  0  7  0  0  0
6  0  0  0  0 35 36  0  0 35 36  0  7  0  0  0  0  0 41  0 35 36  0  6  0
6  0 35 36  0 37 38  0  0 37 38  6  0  0  0  0  0  0 41  0 37 38  0  0  0
0  6 37 38  0  0  0  0  0  0  0  0  0  0  0  0 35 36 41  0  0  0  0  0  0
0  6  0  0  0 39  0  0  0  0  0  0  0  0  0  0 37 38 41  6  6  0 35 36  0
0  0  7  0  0  0  0  0  0  0  0  0  0  0  0 35 36  0 41  0  6  0 37 38  0
0 35 36  0  0  0  0  0  0  0  0  0  0  0  0 37 38  0 41  0  6  6  0  0  0
0 37 38  0  0 35 36  0 35 36  0 35 36  0 35 36  0  0 43 42 42 42 42 42 42
0  0  0  0  0 37 38  0 37 38  0 37 38  0 37 38  0  0  0  0  0  0  0  0  0
0 39  0  0  0  0  0  0  0  0  0  0  0  0  0  0  0  0  0  0  0  0  0  0  0
0  0  0  0  0  0  0  0  0  0  0  0  0  0  0  0  0  0  0  0  0 39  0  0  0
0  0  0 35 36  0  0  0  0  0  0  0  0  0  0  0  0  0  0  0  0  0  0  0  0
0  0  0 37 38  0  0  0  0  0  0  0  6  0  0  0  0  0  0  0  0  0 35 36  0
0  0  0  0  0  0  0  0  0 35 36  0  6  0  0 35 36  0  0  0  0  0 37 38  0
0  0  0  0  0 40  0  0  0 37 38  0  6  0  0 37 38  0  0  0  0  0  0  0  0
0  0  0  0  0  0  0  0  0  0  0  0  0  0  0  0  0  0  0  0  0  0  0  0  0